NO textures/pngwing.xpm
EA textures/pngwing.xpm
WE textures/pngwing.xpm
SO textures/pngwing.xpm

F 224,172,105
C 205,249,255

11111111111111111111
10000000000000000001
10000000000000000001
10000000000000000001
10000000000000000001
10000000000000000001
10000000000000000001
10000000000000000001
10000000000000000001
100000000000000000E1
11111111111111111111
